1111111111
10E1C00001
1011110101
10000001P1
1111111111